111111111111111111111111111111111111111111111
1E0000000000000C00000C00000000000000000000011
101001010010000010100100000001010000000000001
101001001010101000100100000001010C00000000001
101001001010101000100100000001010000000000001
101001001010101000100100000001010000000000001
101001001010101000100100000001010000000000001
101001001010101000100100000001010100000000001
101001001010101000100100000001010100000000001
101001001010101000100100000001010100000000001
101001001010101000100100000001010000000000001
101001001010101000100100000001010100000000001
101001001010101000100100000001010100000000001
101001001010101000100100000001010000000000001
111001001010101000100100000001111000000000001
1PC000000C00C00000000000000000011100000000001
111111111111111111111111111111111111111111111
