11111111111111111111
1CCCC0000CCCC0000001
1CCCC0000CCCC0000001
1CCCC000ECCCC0000001
1CCCC0000CCCC0000001
10000CCCC0000CC11111
10000CCCC0C00C000001
10000CCC10000C111001
10000CC1C0C01C11C001
100000001001P0111111
11111111111111111111